====================
=..................=
==================.=
=..................S
=.==================
=..................=
==================.=
=..................=
=.==================
=..................=
==================.=
=..................=
=.==================
=..................=
==================.=
=..................=
=.=============.====
=........======.====
========.===.......=
========E===========
