====================
S.......E===========
====================
========.===========
========.===========
========.===========
========.===========
========.===========
========.===========
========.===========
========.===========
========.===========
========.===========
========.===========
========.===========
========.===========
========.===========
========.===========
========.===========
====================
