====================
=..................=
==================.=
=..................E
=.==================
=..................=
==================.=
=..................=
=.==================
=..................=
==================.=
=..................=
=.==================
=..................=
==================.=
=..................=
=.=============.====
=........======.====
========.===.......=
========S===========
