====================
S........===========
========.===========
========.===========
========.===========
========.===========
========.===========
========.===========
========.===========
========.===========
========.===========
========.===========
========.===========
========.===========
========.===========
========.===========
========.===========
========.===========
========.===========
========E===========
