====================
S........===========
========.===========
========.===========
========.===========
========.===========
========.===========
========.===========
========.===========
========.===========
========.===========
========.===========
========.===========
========.===========
========.===========
========.===========
========.===========
========.===========
========..==========
=========E==========
